16 
16
MMMMMMMMMMMMMMMM
MMMMMMMMMMMMMMMM
MMMMMMMMMMMMMMMM
MMMSSSSSSSSSSMMM
MMMSSSSSSSSSSMMM
MMMSSGGGGGSSSMMM
MMMSSGSSSGGSSMMM
MMMSSGSSSSGSSMMM
MMMSSSSSSSGSSMMM
MMMSSSSSSSGSSMMM
MMMSSSSSSSGSSMMM
MMMSSSSSSSSSSMMM
MMMSSSSSSSSSSMMM
MMMMMMMMMMMMMMMM
MMMMMMMMMMMMMMMM
MMMMMMMMMMMMMMMM
