16 
16
PPPPPPPPPPPPPPPP
PPPPPPPPPPPPPPPP
PPPPPPPPPPPPPPPP
PPPSSSSSSSSSSPPP
PPPSDDDDDDDDSPPP
PPPSDSSSSSSDSPPP
PPPSDSSSSMSDSPPP
PPPSDSSSSSSDSPPP
PPPSDSSSSSSDSPPP
PPPSDSSSSSSDSPPP
PPPSDSSSSSSDSPPP
PPPSDDDDDDDDSPPP
PPPSSSSSSSSSSPPP
PPPPPPPPPPPPPPPP
PPPPPPPPPPPPPPPP
PPPPPPPPPPPPPPPP
