16 
16
PPPPPPPPPPPPPPPP
PPPPPPPPPPPPPPPP
PPPPPPPPPPPPPPPP
PPPSSSSSSSSSSPPP
PPPSSSSSSSSSSPPP
PPPSDDDDDDDSSPPP
PPPSDSSSSSDSSPPP
PPPSDSSSSSDSSPPP
PPPSDSSSSSDSSPPP
PPPSDSSSSSDSSPPP
PPPSDSSSSSDSSPPP
PPPSDDDDDDDSSPPP
PPPSSSSSSSSSSPPP
PPPPPPPPPPPPPPPP
PPPPPPPPPPPPPPPP
PPPPPPPPPPPPPPPP
