14 
14
PPPPPPPPPPPPPP
PPPPPPPPPPPPPP
PPPPPPPPPPPPPP
PPPXSSSSSSSPPP
PPPMSMMMSSSPPP
PPPSSMMMSSSPPP
PPPSSMMMSSSPPP
PPPMSSSSSSSPPP
PPPSSSSSSSSPPP
PPPSSMSSMSSPPP
PPPSSSSSSSSPPP
PPPPPPPPPPPPPP
PPPPPPPPPPPPPP
PPPPPPPPPPPPPP
